1111111111111111111111111
10C1000000C000000C0000001
10000111110C1100000000001
1P0011E0000C1C000000000C1
1111111111111111111111111
